11.ox
......o.o..
oo.........
oo.o.......
...o.oo...o
...o..o....
......o..oo
o.oo...oo..
...o..oo.oo
.o.ooo.o.o.
oo.....o...
..o.....o.o.
