8.ox
oooo...oooo
o..ooo..oo.
.o..o...o..
.ooooo.o.oo
.ooDoo...oo
o...ooo.ooo
...o.o.....
oo..ooo..o.
