12.o
.......oo
.........
.........
.....o...
.........
.o..oo...
.........
.o.......
.........
....o....
o........
.........
